111111111111
100000001111
111100000111
100000000111
111111111111
