111111111111
100001000001
110000100011
100100000001
111111111111
