1111111111111111111111111111111
1111100000000011100000000000001
1111000000CX000C00C0C00C00000E1
1000000000110011001010010011111
100000C000110000000000000011111
10P0001100000000000011100011111
1111111111111111111111111111111