1111111111111111111111111
1P0000000000000000000X001
1111111111111111101111101
1000000000010000000000001
1010111111010111111011101
1000100000010000X00010001
1110101111010111111010111
1C00100000010000000010001
1011110111101111011110101
1000000100000X00001000011
1011100101111111110101111
1C00000100000C00X001000E1
1010111110111011111011101
1000000000001000000000001
1111111111111111111111111