111111111111
1P000X010001
101111111011
1C00000100E1
101011111011
1C0000000001
111111111111