11111111111111
10000000000001
100000C1E00001
10000111110001
100000C1C00001
1P000000000001
11111111111111