111111111111111111111111111111111111111111111111111111111111
1P00000000000000000000C0000000000000000000000000000000000001
101111011111011111011111011111011111011101111101111101111101
100001000001000001000001000001000001000001000001000001000001
101101110101110111010111010111010111010111010111010111011101
1000000000000C0000000000000000000000000000000000C00000000001
101111111111111111111111111111111111111111111111111111111101
100000000000000000000000000000000C00000000000000000000000001
101111101111101111101111101111101111101111101111101111101101
100000001000001000001000001000001000001000001000001000000001
101011101011101011101011101011101011101011101011101011101101
100010000010000010000010000010000010000010000010000010000001
111011111011111011111011111011111011111011111011111011111011
1C0000000000000000000000000000000000000000000000000000000001
111111111011111111101111111110111111111011111111101111111111
100000000010000000001000000000100000000010000000001000000001
101111111110111111111011111111101111111110111111111011111101
10000000000000000000000000C000000000000000000000000000000001
111111111111111111111011111111111111111111111111111111111101
1C0000000000C0000000000000000C00000000000000000C0000000000E1
101111111111111111111111111111111111111111111111111111111101
100000000000000000000000000000000000000000000000000000000001
101111011111011111011111011111011111011111011111011111011101
100001000001000001000001000001000001000001000001000001000001
101101110101110111010111010111010111010111010111010111011101
1000000000000000000000C0000000000000000000000000000000000001
101111111111111111111111111111111111111111111111111111111101
100000000000000000000000000000000000000000000000000000000001
111111111111111111111111111111111111111111111111111111111111