1111111111111111111111111
1P00000000100000000000001
1011111101011111101111101
1000000000010000000000001
1010111111010111111011101
1000100000010000000010001
1110101111010111111010111
1C00100000010000000010001
1011110111101111011110101
1000000100000000000100001
1011100101111111110101111
1C00000100000C000001000E1
1010111110111011111011101
1000000000001000000000001
1111111111111111111111111